A              #
##### ######## #
#     #      # #
# ### # #### # #
# #   #    # # #
# # ###### # # #
# #        # # #
# ########## # #
#            # #
########### ## #
#              #
# ##############
#              #
############## #
#              B